1111111111111111111111
1E000100000001000C0001
10000X0000C00100000001
1111110000000100C00001
100C000000000100000001
100000C0111111000C0001
1000X00010000000011111
10000000100X0000000001
100000000000000100C001
111X11000C000001000001
10C0010000000001000001
10000100000C000100P001
1111111111111111111111